12 12
111111111111
111111223301
111222223301
111122230001
111222230011
111222330111
111222233001
112223330001
111122233301
122222222331
222211100002
333332221110